START 1
zzzzzzzzzzzzzzzzzzzzzzzzzzzzzzzzzzzzzzzzzzzzzzzzzzz
H                                                 H
H                                                 H
H            1   1   1       1   1   1            H
H                                                 H
H                                                 H
H                                                 H
H                                                 H
H                                                 H
H                                                 H
H                                                 H
H                                                 H
H                                                 H
H                                                 H
H                                                 H
H                                                 H
H                                                 H
H                                                 H
H                                                 H
H                                                 H
H                                                 H
H                                                 H
H                                                 H
H                                                 H
H                                                 H
H                                                 H
H                                                 H
H                                                 H
H                                                 H
H                                                 H
H                                                 H
H                                                 H
H                                                 H
H                                                 H
H                                                 H
H                                                 H
H                                                 H
H                                                 H
H                                                 H
zzzzzzzzzzzzzzzzzzzzzzzzzzzzzzzzzzzzzzzzzzzzzzzzzzz
END 1
START 2
zzzzzzzzzzzzzzzzzzzzzzzzzzzzzzzzzzzzzzzzzzzzzzzzzzz
H                                                 H
H                                                 H
H        1   1   1   1   1   1   1   1   1        H
H                                                 H
H                                                 H
H                                                 H
H                                                 H
H                                                 H
H                                                 H
H                                                 H
H                                                 H
H                                                 H
H                                                 H
H                                                 H
H                                                 H
H                                                 H
H                                                 H
H                                                 H
H                                                 H
H                                                 H
H                                                 H
H                                                 H
H                                                 H
H                                                 H
H                                                 H
H                                                 H
H                                                 H
H                                                 H
H                                                 H
H                                                 H
H                                                 H
H                                                 H
H                                                 H
H                                                 H
H                                                 H
H                                                 H
H                                                 H
H                                                 H
zzzzzzzzzzzzzzzzzzzzzzzzzzzzzzzzzzzzzzzzzzzzzzzzzzz
END 2
START 3
zzzzzzzzzzzzzzzzzzzzzzzzzzzzzzzzzzzzzzzzzzzzzzzzzzz
H                                                 H
H                                                 H
H        1   1   1   1   1   1   1   1   1        H
H                                                 H
H        1   1   1               1   1   1        H
H                                                 H
H                                                 H
H                                                 H
H                                                 H
H                                                 H
H                                                 H
H                                                 H
H                                                 H
H                                                 H
H                                                 H
H                                                 H
H                                                 H
H                                                 H
H                                                 H
H                                                 H
H                                                 H
H                                                 H
H                                                 H
H                                                 H
H                                                 H
H                                                 H
H                                                 H
H                                                 H
H                                                 H
H                                                 H
H                                                 H
H                                                 H
H                                                 H
H                                                 H
H                                                 H
H                                                 H
H                                                 H
H                                                 H
zzzzzzzzzzzzzzzzzzzzzzzzzzzzzzzzzzzzzzzzzzzzzzzzzzz
END 3
START 4
zzzzzzzzzzzzzzzzzzzzzzzzzzzzzzzzzzzzzzzzzzzzzzzzzzz
H                                                 H
H                                                 H
H        1   1   1   1   1   1   1   1   1        H
H                                                 H
H        1   1   1               1   1   1        H
H                        2                        H
H                                                 H
H                                                 H
H                                                 H
H                                                 H
H                                                 H
H                                                 H
H                                                 H
H                                                 H
H                                                 H
H                                                 H
H                                                 H
H                                                 H
H                                                 H
H                                                 H
H                                                 H
H                                                 H
H                                                 H
H                                                 H
H                                                 H
H                                                 H
H                                                 H
H                                                 H
H                                                 H
H                                                 H
H                                                 H
H                                                 H
H                                                 H
H                                                 H
H                                                 H
H                                                 H
H                                                 H
H                                                 H
zzzzzzzzzzzzzzzzzzzzzzzzzzzzzzzzzzzzzzzzzzzzzzzzzzz
END 4
START 5
zzzzzzzzzzzzzzzzzzzzzzzzzzzzzzzzzzzzzzzzzzzzzzzzzzz
H                                                 H
H                                                 H
H        1   1   1   2   2   2   1   1   1        H
H                                                 H
H        1   1   1               1   1   1        H
H                                                 H
H                                                 H
H                                                 H
H                                                 H
H                                                 H
H                                                 H
H                                                 H
H                                                 H
H                                                 H
H                                                 H
H                                                 H
H                                                 H
H                                                 H
H                                                 H
H                                                 H
H                                                 H
H                                                 H
H                                                 H
H                                                 H
H                                                 H
H                                                 H
H                                                 H
H                                                 H
H                                                 H
H                                                 H
H                                                 H
H                                                 H
H                                                 H
H                                                 H
H                                                 H
H                                                 H
H                                                 H
H                                                 H
zzzzzzzzzzzzzzzzzzzzzzzzzzzzzzzzzzzzzzzzzzzzzzzzzzz
END 5
START 6
zzzzzzzzzzzzzzzzzzzzzzzzzzzzzzzzzzzzzzzzzzzzzzzzzzz
H                                                 H
H                                                 H
H        1   1   1   2   2   2   1   1   1        H
H                                                 H
H        1   1   1               1   1   1        H
H                                                 H
H     1   1   1   1   1   1   1   1   1   1   1   H
H                                                 H
H                                                 H
H                                                 H
H                                                 H
H                                                 H
H                                                 H
H                                                 H
H                                                 H
H                                                 H
H                                                 H
H                                                 H
H                                                 H
H                                                 H
H                                                 H
H                                                 H
H                                                 H
H                                                 H
H                                                 H
H                                                 H
H                                                 H
H                                                 H
H                                                 H
H                                                 H
H                                                 H
H                                                 H
H                                                 H
H                                                 H
H                                                 H
H                                                 H
H                                                 H
H                                                 H
zzzzzzzzzzzzzzzzzzzzzzzzzzzzzzzzzzzzzzzzzzzzzzzzzzz
END 6
START 7
zzzzzzzzzzzzzzzzzzzzzzzzzzzzzzzzzzzzzzzzzzzzzzzzzzz
H                                                 H
H                                                 H
H        1   1   1   2   2   2   1   1   1        H
H                                                 H
H        1   1   1               1   1   1        H
H                                                 H
H     1   2   1   2   1   2   1   2   1   2   1   H
H                                                 H
H                                                 H
H                                                 H
H                                                 H
H                                                 H
H                                                 H
H                                                 H
H                                                 H
H                                                 H
H                                                 H
H                                                 H
H                                                 H
H                                                 H
H                                                 H
H                                                 H
H                                                 H
H                                                 H
H                                                 H
H                                                 H
H                                                 H
H                                                 H
H                                                 H
H                                                 H
H                                                 H
H                                                 H
H                                                 H
H                                                 H
H                                                 H
H                                                 H
H                                                 H
H                                                 H
zzzzzzzzzzzzzzzzzzzzzzzzzzzzzzzzzzzzzzzzzzzzzzzzzzz
END 7
START 8
zzzzzzzzzzzzzzzzzzzzzzzzzzzzzzzzzzzzzzzzzzzzzzzzzzz
H                                                 H
H                                                 H
H        1   1   1   2   2   2   1   1   1        H
H                                                 H
H        1   1   1               1   1   1        H
H                                                 H
H     1   2   1   2   1   2   1   2   1   2   1   H
H                                                 H
H                 1   1   1   1   1               H
H                                                 H
H                                                 H
H                                                 H
H                                                 H
H                                                 H
H                                                 H
H                                                 H
H                                                 H
H                                                 H
H                                                 H
H                                                 H
H                                                 H
H                                                 H
H                                                 H
H                                                 H
H                                                 H
H                                                 H
H                                                 H
H                                                 H
H                                                 H
H                                                 H
H                                                 H
H                                                 H
H                                                 H
H                                                 H
H                                                 H
H                                                 H
H                                                 H
H                                                 H
zzzzzzzzzzzzzzzzzzzzzzzzzzzzzzzzzzzzzzzzzzzzzzzzzzz
END 8